entity-logo|This is the business or government entity's logo as an image file (GIF, JPG, PNG, BMP)
entity-rbn|This is the business or government entity's registration number
entity-dor|This is the business or government entity's date of registration
entity-name|This is the business or government entity's Full Name
entity-department|This is the business or government entity's department
entity-address|This is the business or government entity's street address
entity-suburb|This is the business or government entity's suburb
entity-state|This is the business or government entity's state/province
entity-postcode|This is the business or government entity's postcode/ZIP Code
entity-country|This is the business or government entity's country
entity-email|This is your business or government entity email address [maybe verified] 
entity-manager-email|This is your business or government entity's manager's email address [maybe verified] 
entity-accountant-email|This is your business or government entity's accountant's email address
entity-paypal-email|This is your business or government entity's PayPal email address
entity-phone|This is your business or government entity's main switch phone number<br/>(Include Country code ~ without plus ie. Australia = 61)
entity-fax|This is your business or government entity's departments fax number<br/>(Include Country code ~ without plus ie. Australia = 61)
entity-mobile|This is your business or government entity's mobile number [maybe verified]<br/>(Include Country code ~ without plus ie. Australia = 61)
entity-twitter|This is your business or government entity's full twitter profile URL
entity-facebook|This is your business or government entity's full URL for it's Facebook Page/Group
entity-linkedin|This is your business or government entity's full URL for it's Linked-in Group
entity-googleplus|This is your business or government entity's full URL for it's Google+ Page
entity-youtube|This is your business or government entity's full URL for it's YouTube Channel
entity-blog|This is your business or government entity's full URL for it's Journal/Blog URL
photo|A recent clear image of yourself (GIF, JPG, PNG, BMP)
name|Your own full name
address|Your own home street address
suburb|Your own home suburb
state|Your own home state/province
postcode|Your own home postcode/ZIP Code
country|Your own home country
gender|Your own sex type/gender
dob|Your personal date of birth
email|Your own private email address [maybe verified]
paypal-email|Your own private PayPal email address
im-type|Your own Instant Messaging Type
im-address|Your own Instant Messaging Address
phone|Your own home phone number<br/>(Include Country code ~ without plus ie. Australia = 61)
fax|Your own home fax number<br/>(Include Country code ~ without plus ie. Australia = 61)
mobile|Your personal mobile number [maybe verified]<br/>(Include Country code ~ without plus ie. Australia = 61)
twitter|Your own personal full URL for your Twitter Profile
facebook|Your own personal full URL for your Facebook Profile
linkedin|Your own personal full URL for your Linked-in Profile
googleplus|Your own personal full URL for your Google+ Profile
youtube|Your own personal full URL for your YouTube Channel
blog|Your own personal full URL for your Personal Blog
image|The image you wish to attach and embed for this identification (JPG, PNG, GIF, BMP)
serial-number|The identifications number
expiry-month|The month the identification expires
expiry-year|The year the identification expires
issue-country|The country of issue for the identification